000000000000000000000000000011000000000000000000000000000000000000000000000000000000000000000000
000000000000000000000000000011000000000000000000000000000000000000000000000000000000000000000000
000000000000000000000000000011000000000000000000000000000000000000000000000000000000000000000000
000000000000000000000000000011000000000000000000000000000000000000000000000000000000000000000000
000000022222000000000000000011000000000000000000000000000000000000000022222222220000000000000000
000000000000000000000000000011000000000000000000000000000000000000000211111111110000000000000000
220000000000000002200000222211000000000022222222222000000000000000002111111111110000000000000000
112222222222222221100000111111000000000211111111111200000002222222221111111111110000000000000000
111111111111111111100000000000000000002111111111111120000001111111111111111111110000000000000000
111111111111111111100000000000000000021111111111111112000000000000000000000000000000000000000000
111111111111111111100000000000000000211111111111111111200000000000000000000000000000000000000000
111111111111111111100000022222000002111111111111111111122222222222222222222222220000000000000000
111111111111111111100000011111000001111111111111111111111111111111111111111111110000000000000000
111111111111111111133333311111333331111111111111111111111111111111111111111111110000000000000000
111111111111111111133333311111333331111111111111111111111111111111111111111111110000000000000000
111111111111111111133333311111333331111111111111111111111111111111111111111111113333333333333333
111111111111111111133333311111333331111111111111111111111111111111111111111111113333333333333333
333333333333333333333333333333333333333333333333333333333333333333333333333333333333333333333333
333333333333333333333333333333333333333333333333333333333333333333333333333333333333333333333333
333333333333333333333333333333333333333333333333333333333333333333333333333333333333333333333333